R 600 300
NO ./images/wall_n.xpm
SO ./images/wall_s.xpm
WE ./images/wall_w.xpm
EA ./images/wall_e.xpm
S ./images/ITEM.xpm
F 110,153,151
C 180,180,180

111111111111111111111111
102200220022002200220021
102200220022002200220021
102200220022002200220021
102200220022002200220021
102200220022N02200220021
102200220022002200220021
102200220022002200220021
102200220022002200220021
102200220022002200220021
111111111111111111111111