R 600 400
NO ./images/wall_n.xpm
SO ./images/wall_s.xpm
WE ./images/wall_w.xpm
EA ./images/wall_e.xpm
S ./images/ITEM.xpm
F 110,30,10
C 1,1,1

111111111111
102200002201
102200002201
102201102201
102201102201
102201102201
102201102201
102201102201
102201102201
102201102201
102201102201
102001102201
102201102201
10N201102201
111111111111
