R 600 400
NO images/gun.xpm
SO images/gon.xpm
WE images/gam.xpm
EA images/lee.xpm
S images/ITEM.xpm
F 110,30,10
C 1,1,1

 111111111111111111
 133333333321333331
 132222222221222221
 132222222221000001
 132222312221111111
 132212312221
 132222312221
 132222312221
 132222312221
 132222312221
 132222312221
 132222312221
 132222312221 
 13N222312221
 111111111111
